NO textures/minecraft/grass.xpm
SO textures/minecraft/grass.xpm
WE textures/minecraft/grass.xpm
EA textures/minecraft/grass.xpm

F 0,70,28
C 96,139,219

1111111111111111111
1000000000000000001
1000000001000001001
1000001001111101111
1000111000001001001
1000000000000001001
1000000000000001001
1111000000000001011
100000000100N000001
1111111111111111111