F 40,40,40
C 30,30,30

NO textures/wolfenstein/grey_stone.xpm
SO textures/wolfenstein/mossy.xpm
EA textures/wolfenstein/grey_stone.xpm
WE textures/wolfenstein/mossy.xpm

1111111111111111111
10S1001001001000001
1011000001000001001
1001001001111101111
1001111000001001001
1000000000000001001
1001111111111001001
1111000000000001011
1000000001000000001
1111111111111111111

