NO textures/minecraft/mycelium.xpm
SO textures/minecraft/dirt.xpm
WE textures/minecraft/dirt.xpm
EA textures/minecraft/mycelium.xpm

 C 111,11,111
F 75,56,37

111111111111111
111111000111111
111110000011111
1111000N0001111
111000000000111
110000010000011
100001111100001
110000111000011
111000010000111
111100000001111
111110000011111
111111000111111
111111111111111

