NO textures/test/north.xpm
SO textures/test/south.xpm
WE textures/test/west.xpm
EA textures/test/east.xpm

F 20,20,20
C 200,200,200

0000
111111111111111111111111
1000000010000000000E100 
111111111111111111111111
