NO textures/wolfenstein/eagle.xpm
SO textures/wolfenstein/eagle.xpm
EA textures/wolfenstein/red_brick.xpm
WE textures/wolfenstein/red_brick.xpm

F 20,20,20
C 200,200,200

1111111
100N001
1000001
1000001
1100011
1000001
1000001
1000001
1100011
1000001
1000001
1000001
1100011
1000001
1000001
1000001
1100011
1000001
1000001
1000001
1100011
1000001
1111111