NO ./textures/test/north.xpm
SO ./textures/test/south.xpm
WE textures/test/west.xpm
EA textures/test/east.xpm
F 106,73,48
C 26,95,164

1111111
1000001
1111111