NO ./textures/test/north.xpm
SO ./textures/test/south.xpm
WE textures/test/west.xpm
EA textures/test/east.xpm
F 106,73,48
C 26,95,164

1

11111111111111111111
10000000000000000001
10000000000000000001
10000000000000000001
1000000N000000000001
10000000000000000001
10000000000000000001
11111111111111111111