 
 
 
 NO ./textures/north.xpm
SO ./textures/south.xpm
   WE ./textures/west.xpm
  EA  ./textures/east.xpm 


	F 220,100,0
C 225,30,07

1111111111111111
1000000000000001
1000000000000001
1000000000000001
1000000000000001
1000000000000001
1000000000000001
1111111111111111
