 
 
 
 NO ./textures/north.xpm
SO ./textures/south.xpm
   WE ./textures/west.xpm
  EA  ./textures/east.xpm 


	F 220,100,0
C 225,30,07

check plusieurs virgules d'affilé ou virgule à la fin
111111111
100000001
111111111