NO textures/test/north.xpm
SO textures/test/south.xpm
WE textures/test/west.xpm
EA textures/test/east.xpm 

F 106,73,48
C 26,95,164


1111111111111111
10000010000000010
1000000000000001
1000000000000001
100000100000000111111
100000000000000000001
100000000010000111111
1111111111111111